have (had; had )|иметь; получать; быть должным  
not|не, нет; ни 
was|был, была, было; пр. вр. ед. ч. гл. to be (с I, he/she/it)
that|тот, та, то 
do (did; done )|делать 
with|с, вместе с 
say (said; said )|говорить 
her|её
for|в течение, на, для 
as|как; когда 
are|мн. ч. наст. врем. гл. to be (с we, you, they)  
we|мы  
but|только, лишь; кроме; но, а  
can|(прош. врем. could ) мочь; уметь  
him|его 
they|они
up|наверх(у), выше; вверх по, вдоль по 
what|что 
out|вне, снаружи; вне,
me|мне, меня  
go (went; gone )|идти, ехать; уходить  
get (got ; got)|получать; брать; приобретать 
this|этот, эта, это 
from|от, из, с 
be|(was/were/ [wW]; been [bJn]) быть, существовать; находиться и др.
look|взгляд; смотреть
my|мой
there|там, туда; вот
know (knew ; known|[noun]) знать
all|все, вся, всё  
one|один; один 
no|нет;не  
see (saw ; seen|[sJn]) видеть
will|1) вспом. гл. в Future Ind.; 2) как модальный 
back|спина; задний
into|в  
like|похожий;как, подобно; любить, нравиться 
if|если 
were|были; прош. врем. мн. ч. гл. to be (с we, you, they) 
then|тогда; затем 
an|артикль неопредел.
come (came ; come)|приходить, приезжать; случаться
think (thought ; thought)|думать; считать, полагать 
so|так; тоже, также
down|вниз, внизу; вниз по, вдоль по
your|твой, ваш
them|их, им 
would|1) вспом. гл.; 2) как
about|кругом, вокруг; около; о, об, относительно 
man|(мн. ч. men) человек,
take (took ; taken|[teIkn]) брать; доставлять; принимать 
just|только что
by|у, около 
am|1-е л. ед.ч. наст. врем. гл. to
now|теперь, сейчас 
over|над; свыше 
make (made ; made)|делать, производить; совершать 
been|прич. пр. вр. гл. to be
or|или   
time|время; раз 
when|когда  
hand|рука  
who|кто; который 
want|хотеть
here|здесь, тут
tell (told ; told)|говорить
off|с, от 
right|правый;верно
their|их  
turn|поворачивать(ся)
two|два
through|через, сквозь
eye|глаз; взгляд 
head|голова  
other|другой, иной, еще; другой; others- другие 
how|как 
some|несколько
more|больше, более 
around|кругом, вокруг; поблизости; вокруг, по 
door|дверь 
room|комната 
face|лицо 
day|день; сутки 
where|где; куда 
way|путь, дорога 
night|ночь; вечер 
well|хорошо 
thing|вещь, предмет 
open|открывать(ся)
away|далеко; прочь
give (gave ; given|[gIvn]) давать
only|только 
something|что-то, что-нибудь;примерно, около
ask|спрашивать 
move|двигать(ся) 
stand (stood ; stood)|стоять; ставить; терпеть; стойка 
good|хороший; добро
find (found ; found)|находить, обнаруживать 
again|опять, снова
little|маленький  
try|пытаться,
too|также; слишком
still|тихий;все еще
hear (heard ; heard)|слышать; слушать 
walk|ходьба; ходить
before|перед;раньше
leave (left; left)|покидать
sit (sat ; sat)|сидеть
let (let; let)|позволять
long|длинный;долго
call|призыв; звать 
feel (felt; felt)|чувствовать
close|близкий, тесный;близко; закрывать(ся) 
very|очень 
why|почему 
which|который; что 
car|автомобиль, машина
any|какой-нибудь 
hold (held; held)|держать; владеть; вмещать  
work|работа; работать
run (ran ; run)|бежать
never|никогда  
start|начало; начинать(ся)
even|даже; ровно 
light|1) свет; (lit, lighted; lit, lighted ) освещать(ся)
than|чем, нежели  
after|после, через;
put (put; put)|положить 
yes|да  
stop|остановка; останавливать(ся)  
old|старый  
watch|1) смотреть, следить; наблюдение; 2) часы
first|первый; сначала
may|(прош. вр. might) мочь и др.; май (месяц) 
talk|разговор;говорить
another|другой
cut (cut; cut)|резать 
mean|середина; (meant; meant ) значить; подразумевать 
pull|тянуть, тащить 
behind|за;сзади,
smile|улыбка; улыбаться
our|наш 
toward(s)|к 
much|много;много
its|его, её (о предм.) 
house|дом  
keep (kept; kept)|держать
place|место;помещать
begin (began ; begun|[bI'gAn]) начинать(ся); приступать (к)
nothing|ничего 
year|год
woman|(мн. ч. women )
side|сторона
because|потому что
three|три
seem|казаться
wait|ждать
need|нуждаться 
moment|мгновение, момент  
himself|себя; сам
stare|уставиться (на)
arm|1) рука; 2)~s оружие
use|применение, польза; v - употредлять, применять и др.
voice|голос   
last|последний 
late|поздний;поздно
across|через, сквозь;поперек
sure|уверенный;конечно
front|передний 
sound|звук; звучать
big|большой  
really|действительно
name|имя; название
should|1) вспом. гл.; 2) как модальный: должен, следует 
new|новый
anything|что-нибудь; что угодно 
against|против 
guy|парень
kill|убивать
point|острие; точка; пункт; смысл; указывать на 
small|маленький  
happen|случаться
wall|стена
black|черный 
step|шаг; шагать
window|окно
life|жизнь
maybe|может быть
fall (fell; fallen )|падать, понижаться; падение; осень
own|свой; владеть 
far|дальний;далеко
under|под; ниже 
boy|мальчик, парень  
end|конец; кончать(ся)
those|те
reach|достигать 
while|в то время как
floor|пол; этаж  
street|улица
help|омощь; помогать
girl|девочка, девушка  
next|следующий; будущий; потом, затем; рядом 
few|немного; a ~
white|белый   
must|должен, обязан
feet|(мн. ч. от foot) ноги
table|стол   
these|эти
show|показ; (showed ; shown [Soun], редк. showed) показывать 
okay или OK|хорошо!, ладно!, есть!  
enough|достаточно
phone|телефон; звонить по телефону 
body|тело
same|тот же самый
minute|минута
shake (shook ; shaken|['SeIkn]) трясти(сь); дрожать; потрясать
water|вода
fire|огонь; пожар; стрелять; поджигать 
inside|внутренний;внутри; внутрь  
break (broke ; broken|[broukn]) ломать(ся); пролом; перерыв 
ever|когда-либо 
follow|следовать (за)
second|секунда; второй 
nod|кивать головой; кивок
meet (met; met)|встречать(ся); знакомиться
great|большой, великий
yeah|разг. от yes - да
each|каждый, всякий  
mind| разум; мнение
suddenly|вдруг
dead|мертвый  
almost|почти 
gun|огнестр. оружие
both|оба
speak (spoke ; spoken|[spoukn]) говорить, разговаривать 
love|любовь; любить 
pick|собирать; выбирать
home|дом  
without|без  
win (won; won )|выиграть
once|однажды 
word|слово
better|лучше 
every|каждый 
god|бог 
build (built; built)|строить; building также здание
until|до тех пор пока
beat (beat; beaten )|бить 
course|курс; of course- конечно
lot|жребий, судьба; a lot of, lots of –много, масса 
drive (drove ; driven|ехать; управлять (автомоб.); езда
bring (brought; brought )|приносить; приводить; привозить 
along|по; вперед
five|пять   
hard|твердый, трудный;сильно, упорно
air|воздух; воздушный 
continue|продолжать(ся)
most|большинство; наибольший;наиболее  
pass|проходить, проезжать; выдержать (экзамен); пропуск
always|всегда   
kid|ребенок, малыш; подшучивать; обманывать 
believe|верить  
half|половина    
line|линия; проводить линии; выстраивать(ся) в ряд  
high|высокий; высший;высоко
set (set; set)|ставить, помещать; комплект, набор   
read (read ; read|[red])|читать
world|мир, вселенная  
hour|час   
office|контора 
play|игра; играть  
young|молодой, юный
answer|ответ; отвечать
shoot (shot; shot)|стрелять
dark|темнота;
laugh|смех; смеяться
bed|кровать, постель  
thank|благодарить
remember|помнить,
drop|капля; капать
friend|друг, подруга 
though|однако; хотя
glass|стекло; стакан
hair|волос, волосы 
hell|ад, преисподняя
catch (caught ; caught)|ловить, поймать, застигнуть; захват
mother|мать
four|четыре
listen|слушать
understand (understood ; understood)|понимать
sir|сэр, господин   
lose (lost; lost)|терять; проигрывать; отставать (о часах) 
lie|1) (lay ; lain [leIn]) лежать; 2) ложь; лгать
between|между
live|жить
money|деньги
father|отец
morning|утро
red|красный
please|нравиться  
everything|всё
slowly|медленно
rise (rose ; risen|[rIzn]) подниматься, вставать; восходить    
die|умирать
else|еще; кроме 
kind|сорт, вид; добрый, любезный 
wear (wore ; worn|[wLn]) носить (одежду и т.п.); одежда  
hit (hit; hit)|ударять(ся); попадать; удар; попадание
hang (hung; hung ;|висеть; вешать;  hanging вешание; висячий
many|многие, множество; многие, много
someone|кто-то
drink (drank ; drunk[drANk])|пить; выпивать; питье 
stay|пребывание; оставаться; жить  
shoulder|плечо  
past|прошлое; прошлый; после, за; мимо  
grab|хватать(ся)
question|вопрос; проблема; распрашивать 
part|часть; роль 
case|1)  случай; обстоятельство; 2) ящик, чемодан  
mouth|рот
throw (threw ; thrown[Troun])|бросать, кидать 
enter|входить (в) 
hundred|сто  
cover|(по)крышка; покрывать, прикрывать   
blood|кровь   
check|проверка, контроль; проверять, контролировать  
outside|наружный, внешний;снаружи 
large|большой, крупный
change|изменение, перемена; менять(ся), изменять(ся)
push|толчок; толкать(ся); нажимать 
sorry|сожалеющий  
bad|плохой  
top|верх; верхний 
chair|стул, кресло  
finger|палец
lead (led; led)|вести 
scream|крик, вопль; кричать, вопить  
ground|земля   
already|уже
forward|вперед; передний 
figure|фигура; цифра; вычислять; понимать  
touch|прикосновение; трогать, касаться  
become (became ; become)|становиться, делаться  
yet|еще; однако 
also|также  
desk|письменный. стол 
clear|очищать; чистый
real|действительный  
carry|нести; везти  
sleep (slept; slept)|спать
glance|(быстрый) взгляд; (мельком) взглянуть  
seat|сиденье; место; усаживать; вмещать  
matter|дело, вопрос; иметь значение   
number|число  
ship|корабль, судно  
full|полный  
police|полиция  
twenty|двадцать 
send (sent; sent)|посылать; отправлять; присылать  
gonna|сокр. = going to– собираться что-либо сделать  
together|вместе
ten|десять 
roll|рулон; раскат; катить(ся); грохотать; качать(ся)
return|возврат; ответный; возвращать(ся); отвечать
such|такой  
near|ближний;близко; около; приближаться  
miss|промахнуться; промах; Miss- мисс (дев. или незамужн. ж.)
pay (paid; paid )|платить; плата   
paper|бумага; газета
rest|отдыхать; лежать; покой, отдых; the ~ остаток 
appear|появляться 
park|парк   
above|над; свыше;наверху, выше    
onto|на   
control|управление, контроль; управлять 
fly|1) (flew ; flown [floun]) лететь, летать; мчаться; 2) муха  
pause|пауза, перерыв; делать паузу, перерыв   
road|дорога; путь
probably|вероятно
finally|в заключение
guard|стража, охрана; часовой; охранять; защищать  
draw (drew ; drawn|[drLn]) 1) тащить, тянуть; 2) чертить, рисовать
city|город  
deep|глубокий;
job|работа; дело  
ring|1) (rang ; rung [rAN]) звонить, звенеть; звонок; 2) кольцо; круг
fight|бой; драка; (fought; fought ) бороться, сражаться
leg|нога; ножка  
wonder|удивление; удивляться; интересоваться  
lean|1) прислонять(ся); наклонять(ся); 2) тощий, худой  
since|с;с тех пор; с тех пор как  
hope|надежда; надеяться
left|левый;налево 
sign|знак; подписывать(ся)
cross|крест; пересекать; переходить; скрещивать  
suppose|предполагать
order|порядок; приказ; заказ; приказывать; заказывать  
eat (ate ; eaten|['Jtn]) есть
corner|угол   
wrong|неправильный; не тот;неправильно, неверно  
tear|1) (tore ; torn [tLn]) рвать(ся); разрыв; чаще: 2) [tIq] слеза
shit|восклиц. обычно перев. словом "черт"; груб. дерьмо; гадить
six|шесть  
soon|скоро, вскоре  
fast|быстрый; прочный;быстро; прочно 
bill|счет; банкнота  
quickly|быстро  
shadow|тень  
wife|жена  
dress|платье, одежда; одевать(ся)  
damn|проклятие; проклинать; в знач. междомет.: черт!
guess|думать, полагать
myself|себя; сам
care|забота;заботиться
raise|поднимать 
mile|миля (сухопутн. м. =1609м; морск. м. =1853м) 
land|земля; почва; страна; приземляться; высаживаться 
perhaps|может быть,
bar|1) бар, буфет; 2) засов; преграда; решетка  
blue|синий, голубой 
idea|идея, мысль 
death|смерть   
alone|один, одинокий
best|(наи)лучший;лучше всего; больше всего 
dad, daddy|папа
whole|весь, целый  
tree|дерево    
force|сила; насилие; ~s войска; заставлять, принуждать  
fill|наполнять(ся) 
crowd|толпа; толпиться; набиваться битком
shut (shut; shut)|закрывать(ся); перекрывать; запирать  
business|дело, занятие
blow|1) (blew ; blown [bloun]) дуть; раздувать; 2) удар   
cry|крик; кричать 
write (wrote ; written|['rItn])
notice|извещение; внимание; обращать внимание   
fine|прекрасный; ясный
quite|вполне, совсем
power|сила, энергия 
fact|факт    
pretty|хорошенький  
week|неделя    
nice|хороший; милый   
lock|замок; запирать 
story|повесть, рассказ
dog|собака 
least|наименьший;наименее; n: the ~ самое меньшее 
empty|пустой  
everyone|каждый
wave|волна; взмах (рукой); махать (рукой); развеваться 
several|несколько
silence|молчание 
short|короткий  
cold|холодный
problem|проблема 
fucking|руг. груб. чертов, долбаный, траханный и т.п.
cop|полицейский
thousand|тысяча
approach|приближение; приближаться (к) 
realize|представлять себе, понимать, осознавать 
rock|камень; скала; качать(ся)
piece|кусок; штука   
wind|1) ветер;запах; чуять; 2) (wound; wound [waund]) виться,
box|коробка, ящик  
either|любой (из двух);также (при отриц.) 
sort|сорт, род, вид  
kiss|поцелуй; целовать(ся)
edge|острие, лезвие; край, кромка; точить; окаймлять 
interest|интерес; (за)интересовать  
surprise|удивление; сюрприз; удивлять   
bit|кусочек; a ~ немного 
forget (forgot|; forgotten fq'gOtn]) забывать, не помнить  
stick|1) (stuck; stuck ) втыкать, прикалывать; липнуть; 2) палка
heart|сердце
finish|окончание; заканчивать(ся), кончать(ся)  
fuck|руг. груб. типа: к черту!; ( траханье; трахать) 
grow (grew ; grown|[groun]) расти; увеличиваться; становиться
ago|тому назад  
bag|мешок, сумка 
sense|чувство, ощущение; чувствовать, осознавать  
picture|картина 
ready|готовый   
chance|случай, шанс 
worry|беспокоить(ся
ahead|вперед; впереди
couple|два, пара   
press|1) пресса, печать; 2) нажимать, давить   
doctor|врач, доктор  
book|книга   
officer|офицер 
anyone|кто-нибудь
son|сын
pocket|карман
human|человеческий
family|семья   
safe|безопасный  
burn|(бр. burnt, burnt ; ам. burned, burned [bWnd]) жечь; гореть  
breath|дыхание; вздох
early|ранний;рано
jump|прыжок; прыгать
lift|лифт; поднимать
green|зеленый  
reason|причина; разум  
lay|(laid; laid leId]) класть, положить; (lay также и прош. вр. от lie лежать)
free|свободный     
machine|машина  
beside|рядом с; около
stuff|все, что угодно: вещь, штука, барахло и т.п. 
wide|широкий; широко
round|круглый; круг; огибать; вокруг
expect|ожидать 
neck|шея; горлышко(бут.)
careful|осторожный; внимательный  
lip|губа
school|школа
hide (hid; hidden )|прятать(ся); скрывать(ся); шкура 
deal|(некоторое) количество; доля; сделка, соглашение; реже (dealt; dealt ) распределять, выдавать
whisper|шепот; шептать
space|пространство, место; расстояние; космос
herself|себя; сама 
baby|ребенок; малыш
climb|подниматься(на)
easy|легкий;легко 
plan|план;
yourself|себя; сам 
trouble|заботы, беспокойство; беспокоить(ся)  
slide (slid; slid)|скользить, поскользнуться; скольжение 
thirty|тридцать  
train|1) поезд; 2) воспитывать; тренировать(ся) 
low|низкий;низко  
key|ключ
different|различный
swing (swung; swung )|качать(ся; колебание; размах 
coffee|кофе
radio|радио 
hotel|гостиница,
anyway|в любом случае
shout|крик; кричать 
state|1) штат; государство; государственный; 2) состояние; излагать
study|изучение; обучение, занятия; учить(ся)
foot|(мн. ч. feet) 1) ступня, нога; 2) подножие; 3) фут =30,48 см  
slow|медленный; замедлять(ся)
station|станция; вокзал
brother|брат   
hurt (hurt; hurt)|ушибить; болеть, причинять боль 
game|игра   
heavy|тяжелый 
lady|дама; госпожа   
below|ниже, под;внизу  
kitchen|кухня   
buy (bought; bought )|покупать
area|площадь; район
knock|стук; удар; стучать(ся); бить    
star|звезда
decide|решать(ся)  
view|вид; взгляд, мнение 
flash|вспышка; вспыхивать
sun|солнце
month|месяц
straight|прямой; честный;прямо; немедленно  
truck|грузовик   
shirt|рубашка (мужская)
remain|оставаться 
whatever|любой; все, что; (в отриц. предл.) вообще не 
sky|небо   
suit|удовлетворять требованиям; годиться; костюм   
hot|горячий, жаркий 
boat|лодка; судно 
ride (rode ; ridden|[rIdn]) ехать (верхом, в машине); поездка 
fear|страх; бояться 
pain|боль; страдание
note|заметка; записка; банкнота; отмечать; замечать  
sight|зрение; вид; взгляд
wish|желание; желать
slip|скольжение; ошибка; скользить; поскользнуться 
hall|зал; передняя; холл 
actually|фактически, на самом деле  
group|группа  
learn|(бр. learnt, learnt , ам. learned, learned [lWnd]) учить(ся), изучать;
race|1) раса; род; 2) гонки; мчаться; гнать 
dollar|доллар   
true|правдивый; верный 
children|(мн. ч. от child) дети 
shot|1) выстрел    
afraid|испуганный 
except|кроме
grin|усмешка; ухмыляться
cause|причина; быть причиной, причинять  
exactly|точно  
mark|знак; оценка, балл; ставить знак, отметку 
stone|камень; каменный
computer|компьютер
huge|огромный  
less|меньший;менее
explain|объяснять 
spot|пятно; место; пятнать; узнавать, отмечать  
upon prep|= on – на  
reply|ответ; отвечать
clean|чистый; чистить
centre|бр. = center ам. (1:10) центр
corridor|коридор
chest|грудная клетка 
ear|ухо   
report|доклад, сообщение; докладывать, сообщать   
dream|(бр. dreamt, dreamt ; ам. dreamed, dreamed [drJmd]) видеть во сне; мечта 
living|жизнь; живой
middle|середина; средний
wheel|колесо; катить 
bottle|бутылка   
somebody|кто-то,
able|способный; умелый 
movie|кино, фильм   
driver|водитель 
happy|счастливый 
murder|убийство; убивать  
rather|довольно; вернее, скорее   
offer|предложение; предлагать   
quiet|спокойный  
rush|спешка; бросаться
rain|дождь  
today|сегодня 
freeze (froze ; frozen|[frouzn]) замерзать; замораживать 
bank|1) берег(реки, озера); насыпь; насыпать; 2) банк
bedroom|спальня  
kick|удар ногой; пинок; ударять ногой   
field|поле   
beautiful|красивый
stair|ступенька 
form|форма; бланк; класс; формировать(ся)  
angle|угол 
darkness|темнота
card|открытка; билет
person|человек  
nobody|никто 
hole|дыра, отверстие 
earth|земля; почва   
gray|= grey (3:1) серый; седой
snap|треск; треснуть
war|война  
within|в; внутри
music|музыка   
skin|кожа; шкура   
sea|море   
cigarette|сигарета 
lower|нижний; спускать(ся); понижать(ся)   
attention|внимание 
direction|направление
ice|лед
knee|колено
search|поиски; искать
company|компания
eight|восемь  
block|глыба; квартал (города); преграждать; блокировать  
save|спасать; экономить
smell|(бр. smelt, smelt , ам. smelled, smelled [smeld]) нюхать; пахнуть; запах   
track|след; тропинка; колея ж/д; следить (за)   
weapon|оружие  
horse|лошадь, конь  
apartment|комната;
reveal|открывать, разоблачать; обнаруживать  
charge|заряд; нагрузка; поручение; заряжать; нагружать
record|запись; пластинка; записывать  
clothes|одежда, платье
child|(мн. ч.- children) ребенок
beyond|за; вне, сверх, выше;вдали  
spend (spent; spent)|тратить, расходовать 
tonight|сегодня вечером
loud|громкий; громко
tire|утомлять(ся), уставать
shrug|пожимать (плечами)
slam|со стуком/шумом закрыть, захлопнуть, швырнуть  
position|положение 
arrive|прибывать 
animal|животное 
brown|коричневый 
somewhere|где-нибудь, куда-нибудь   
tape|лента; записывать
soldier|солдат  
nose|нос; обоняние 
tight|тугой;туго 
paint|краска; красить
agent|агент 
hate|ненавидеть   
knife|нож   
colour|бр. = color ам. (1:7) цвет; краска; красить  
strike (struck; struck )|1) ударять(ся); поражать; осенять; 2) бастовать; забастовка  
party|вечеринка; партия
fifty|пятьдесят   
quick|быстрый;быстро
security|безопасность
news|новость, новости
tomorrow|завтра
strange|чужой  
speed|скорость; (sped , speeded ['spJdId]; sped, speeded) спешить
disappear|исчезать
hurry|спешка;
distance|расстояние
file|картотека; регистрировать 
deck|палуба и др.  
possible|возможный
beneath|под, ниже; внизу
bright|яркий, светлый 
country|страна; сельская местность 
handle|ручка; трогать, брать руками; управлять  
act|дело; действовать
afternoon|время после полудня
metal|металл  
telephone|телефон
evening|вечер
seven|семь
certain|определенный; уверенный; один, некий   
crash|грохот; крушение; рушиться с треском; разбиться
quietly|спокойно 
shall|1) вспом. гл. в Future Ind.; 2) как модальный  
frame|каркас; рама; кадр; составлять, формулировать 
island|остров  
store|магазин; склад;
food|пища, еда   
bathroom|ванная; туалет
mom|мама
mirror|зеркало 
plane|плоскость; самолет (=airplane); плоский  
shape|форма, вид; образ; придавать/принимать форму
sigh|вздох; вздыхать 
throat|горло  
fade|вянуть; блекнуть
important|важный
main|основной, главный
sometimes|иногда
ball|шар; мяч   
tie|соединение; лента, шнур; галстук; связывать, скреплять 
crack|треск; трещать
dance|танец; танцы (вечеринка); танцевать  
engine|машина;
exit|выход
itself|себя; сам  
letter|буква; письмо  
bear|1) медведь; 2) (bore ; borne [bLn]- носить;  bore [bL];  born [bLn]- рождать) носить; выносить, терпеть; рождать; (bore также скука; надоедать; а born также прирожденный)
board|доска; борт (судна, самолета); посадка на борт 
join|соединять(ся)
shock|удар; потрясать
everybody|все
add|прибавлять
spin (spun|, span [spxn];  spun) вертеть(ся); вращение
ass|зоол.-осел; дурак 
blade|лезвие  
yard|1) двор; 2) ярд (= 91,4 см)
hello|привет!; алло!
alive|живой
mine|мой
pack|пакет; тюк; упаковывать(ся); заполнять(ся) 
silent|молчаливый 
teeth|(мн. ч. от tooth) зубы
crazy|сумасшедший
gate|ворота, калитка 
none|никто, ничто; никакой, ни один;нисколько 
third|третий  
wake (woke|, waked [weIkt]; woken ['woukn], waked) просыпаться;
age|возраст; стареть
truth|правда, истина  
strong|сильный; крепкий
clock|часы 
camera|фото-, кинокамера  
image|образ; имидж  
noise|шум  
marry|женить(ся), выходить
wood|дерево; лес; в знач. прилагат.: лесной; деревянный  
law|закон; право   
trust|доверие; верить
consider|рассматривать, обсуждать; полагать 
million|миллион  
remove|удалять  
yell|крик; кричать 
struggle|борьба; бороться; биться; делать усилие  
promise|обещание; обещать
instead (of)|вместо,
among(st)|среди
tiny|крошечный
slightly|слегка, едва
shop|магазин  
hospital|больница  
esus|воскл. боже!
bend (bent; bent)|гнуть(ся); сгибать(ся); наклонять(ся) 
count|считать; 1) счет, подсчет; 2) граф  
cool|прохладный 
agree|соглашаться 
river|река   
scare|пугать 
during|в течение
information|информация, сведения, данные  
system|система 
surface|поверхность
service|служба  
bridge|мост
attack|нападение;
lawyer|адвокат 
sing (sang ; sung|[sAN]) петь 
motion|движение  
ray|луч   
hill|холм   
elevator|лифт  
twist|изгиб; виться
dry|сухой; сушить(ся)
thick|толстый; густой 
chief|глава; главный  
button|пуговица; кнопка
level|уровень 
general|общий; обычный; генерал  
flight|полет; рейс   
brain|мозг; ум   
page|страница
pour|лить(ся); наливать 
doorway|дверной
tall|высокий
jacket|куртка, пиджак
bone|кость; останки
sink (sank ; sunk|[sANk]) тонуть; топить; погружать(ся); опускать(ся), понижать(ся); раковина (водопроводная); впадина
gotta|разг. = (have) got to - должен, должна(…ны)  
circle|круг; окружность; вращаться   
gaze|пристальный взгляд; пристально глядеть; уставиться
soft|мягкий; нежный   
drag|тащить(ся) 
desert|пустыня; пустынный; покидать 
certainly|конечно 
fish|рыба; ловить рыбу
beach|пляж; взморье   
single|один, единственный; отдельный; одинокий  
team|команда; группа
bottom|дно; низ 
secret|секрет, тайна; секретный, тайный  
allow|позволять 
immediately|немедленно 
concern|отношение; иметь отношение (к)
husband|муж
burst (burst; burst)|взрываться; лопаться; вспышка; взрыв  
forty|сорок  
sell (sold; sold)|продавать 
leap (leapt|, leaped [lept]; leapt, leaped) прыгать, скакать; перепрыгивать; прыжок, скачок
pound|1) бить(ся), колотить(ся); бомбить; 2) фунт (=454г); 3) фунт (стерлингов) – денежн. ед. 
escape|побег; совершать побег; спастись; ускользать  
cloud|облако; туча; покрывать(ся) тучами   
rear|задняя сторона; тыл 
gold|золото; золотой
simply|просто  
message|сообщение
detective|сыщик, детектив; детективный  
manage|руководить
creature|создание,тварь
themselves|себя
roof|крыша 
inch|дюйм (= 2,54 см)
dinner|обед
gesture|жест; жестикулировать
army|армия 
switch|переключение; выключатель; переключать
nurse|няня; сиделка; ухаживать
expression|выражение
yellow|желтый
sergeant|сержант
warm|теплый; греть(ся)
roar|рев; грохот; реветь; грохотать
club|клуб 
pop|1) хлопнуть, треснуть; 2) сокр. от popular- популярный
grand|грандиозный; большой; важный; восхитительный
bite (bit; bitten)|кусать(ся); жалить; укус; кусок (пищи)
coat|пальто 
size|размер; величина; формат; определять величину
however|как бы ни; однако, тем не менее
cat|кот, кошка 
type|1) тип; род; модедь; 2) печатать на машинке
thin|тонкий; худой; редкий
dozen|дюжина 
crew|экипаж (судна и т.п.)
present|1) настоящее время; присутствующий; 2) подарок; дарить
shoe|(полу)ботинок, туфля
beer|пиво
doubt|сомнение; сомневаться
settle|поселить(ся); устраивать(ся); улаживать; решать
daughter|дочь
anybody|кто-нибудь (в вопр.); никто (в отриц.); любой (в утверд.)
grip|сжатие; хватка; схватывать(за); сжимать
completely|совершенно, полностью
nearly|почти; около 
pair|пара 
nine|девять 
gather|собирать(ся)
bud|сокр. от buddy приятель
bird|птица 
sister|сестра 
special|специальный
hallway|прихожая
base|основа; база; основывать, базировать 
mountain|гора 
flat|квартира 
sweat|пот; потеть
gently|мягко, нежно
spread (spread; spread)|распространять(ся); расстилать(ся)
wire|проволока, провод; телеграмма; телеграфировать
bullet|пуля 
stretch|растягивать(ся)
master|хозяин; мастер
cell|камера; карцер; ячейка
counter|1) прилавок; 2) противоположное; противостоять
private|1) частный; личный; 2) рядовой (воинск. звание)
king|король 
flame|пламя; сияние
sick|больной
rip|рвать(ся 
entrance|вход 
sheet|простыня; лист
entire|целый, полный, весь
steal (stole ; stolen|[stouln])
warn|предупреждать
judge|судья; судить 
perfect|совершенный
command|команда, приказ; приказывать; командовать 
sharp|острый; резкий
scene|сцена; место; явление
screen|экран; ширма; прикрывать
conversation|разговор,
dear|дорогой, милый 
whether|ли
toss|бросание; бросать 
cup|чашка; кубок 
ceiling|потолок 
fit|годный; годиться
narrow|узкий, тесный; суживать(ся); уменьшать(ся) 
imagine|воображать
hrist|Христос; восклицание: боже!; господи!
simple|простой
colonel|полковник
pilot|летчик, пилот
cheek|1) щека; 2) наглость
grace|грация, изящество 
photo|фотография 
buddy|приятель 
excuse|1) извинение; 2) извинять 
frown|хмуриться
tunnel|тоннель
fix|закреплять; чинить
hat|шляпа 
snow|снег 
planet|планета 
glow|свет; сверкать
double|двойной; удваивать; вдвое 
recognize|узнавать
sudden|внезапный 
steel|сталь; стальной 
worse|худший;хуже 
wipe|вытирать, утирать
stupid|глупый, тупой
monitor|монитор; наставник; староста (класса); наставлять
test|испытание; проверка; экзамен; испытывать, проверять
square|квадрат; площадь; сквер; квадратный 
mention|упоминание; упоминать; ссылаться на 
uniform|форменная одежда; форменный; одевать в форму
south|юг; южный;к югу, на юг(е)
travel|путешествие; путешествовать
mask|маска;
fifteen|пятнадцать
class|класс; сорт, качество; в школе- класс, урок, занятие 
path|тропинка; путь 
match|1) спичка; 2) состязание, матч; состязаться
grant|дар; стипендия; дарить, предоставлять 
memory|память
serious|серьезный 
softly|мягко, нежно 
dust|пыль; вытир. пыль
major|1) майор; 2) большой; главный 
wild|дикий; бешеный 
calm|тихий; успокаивать
dig (dug; dug )|рыть(ся) 
angry|сердитый, гневный
wet|мокрый; дождливый 
contact|контакт, связь; связаться
tank|1) танк; 2) цистерна
wrap|обертывать
action|действие 
click|щелканье; щелкать
tower|башня; вышка
crawl|ползание; ползти
whose|чей 
prepare|готовить(ся) 
thought|мысль, размышление
load|груз; грузить
situation|местоположение; ситуация 
trip|поездка, путешествие
ignore|игнорировать
lieutenant|лейтенант
enjoy|наслаждаться 
wing|крыло; воен., спорт. фланг, край; филиал; флигель (дома)
belt|пояс, ремень 
gas|газ; амер. бензин
sweep (swept; swept )|мести, чистить; сметать; нестись, мчаться
north|север; северный 
stage|1) стадия; 2) сцена
bet (bet; bet)|держать пари
bother|беспокойство; надоедать; беспокоить(ся) 
peer|всматриваться
poor|бедный; несчастный
neither|ни один (из двух); ни тот, ни другой;также не
barely|только, едва, лишь
rifle|винтовка 
west|запад; западный
row|1) ряд; этаж; 2) гребля; грести; 3) шум, гвалт; шуметь
beam|луч; сияние; сиять
storm|буря, шторм; штурм
wound|рана; ранить
plate|тарелка; пластинка
share|часть; делить(ся) 
shift|смена; менять(ся) 
drug|наркотик; лекарство
date|дата, число; свидание; датировать; назначать свидание 
plastic|пластмасса; пластичный, гибкий 
ghost|призрак, привидение
pale|бледный 
loose|свободный; незакрепленный
aside|в стороне 
emerge|появляться
hesitate|колебаться, сомневаться; не решаться
often|часто 
mistake|ошибка; редко (mistook ; mistaken [mIs'teIkn]) ошибаться
bang|удар; ударить(ся)
heat|жара; нагревать(ся)
bow|1) поклон; кланяться; 2) лук (оружие); смычок; бант
list|список; вносить в список
movement|движение
complete|полный; законченный; заканчивать, завершать 
include|включать; заключать в себе
feed (fed; fed)|кормить(ся); питаться, есть; питание, еда, корм
blast|взрыв; взрывать 
explode|взрывать(ся)
bitch|сука; ругат. стерва 
weight|вес; тяжесть 
yours|твой, ваш 
address|адрес; адресовать; направлять 
church|церковь 
surround|окружать
pile|куча, груда; складывать, сваливать в кучу;  громоздить
worth|цена, стоимость; ценность; имеющий ценность 
attempt|попытка; покушение; пытаться 
nervous|нервный 
government|правительство 
dawn|рассвет 
trail|след; выслеживать
plant|1) растение; сажать (растения); 2) завод, фабрика 
final|финал; последний
passenger|пассажир
pool|бассейн 
town|город 
wash|мыть(ся); умываться
pace|шаг; шагать 
smash|столкновение; гибель; крах; разбить(ся) вдребезги
television|телевидение
panic|паника; панический; пугать; впадать в панику
self|сам; само- 
admit|впускать; принимать; признавать 
directly|прямо; немедленно
serve|служить; обслуживать; состоять на службе 
map|карта (геогр.) 
fat|жир; жирный; толстый
van|фургон; багажн. вагон
commander|командир
goddamn|проклятие; проклинать 
somehow|как-нибудь
post|почта; отправлять по почте 
frighten|пугать
continuous|непрерывный; длительный 
blind|штора; слепой; ослеплять 
jerk|резкое движение, толчок; резко толкать, дергать 
blink|мигать; мерцать 
boss|хозяин, босс  
nor|ни; также не  
operation|действие
glad|радостный, довольный
pistol|пистолет 
suggest|предлагать 
teach (taught; taught )|учить
although|хотя  
lucky|счастливый 
rule|правило; управлять
apart|в стороне; отдельно
bloody|кровавый 
flip|легкий удар, щелчок; слегка ударить, щелкнуть; смахнуть
flesh|тело, плоть 
witness|свидетель; очевидец; быть свидетелем, видеть
quarter|четвертая часть, четверть; район города, квартал
relax|расслаблять(ся)
clearly|ясно; очевидно
repeat|повторять
asleep|спящий 
helicopter|вертолет 
killer|убийца; ам. гангстер
member|член, участник
parent|родитель
odd|1) нечетный; лишний; странный; 2) odds разница; шансы
bomb|бомба; бомбить
release|освобождать; выпускать (на волю); выпустить/опубликовать
unless|если не 
punch|1) удар кулаком; наносить удар кулаком; 2) компостер
history|история 
busy|занятой 
bond|связь, узы; оковы 
copy|копия; копировать
accept|соглашаться (с)
destroy|разрушать
anymore|обычно в отриц. предл. в знач. больше не; редко в утверд. в знач. когда-нибудь еще
cab|такси 
experience|опыт; впечатление; испытывать; переживать
shove|толчок; толкать(ся)
bastard|незаконнорожденный ребенок; разг.-груб. ублюдок и т.п.
fool|дурак; (о)дурачить 
fold|складка, сгиб; складывать(ся); сгибать(ся) 
twelve|двенадцать
evidence|свидетельство; доказательство, улика 
bus|автобус 
brief|резюме; краткий; кратко излагать
tap|1) кран (водопр. и т.п.); 2) стук; легкий удар; постучать
drift|медленное течение; дрейф и др.; дрейфовать; бездействовать
prove|доказывать; подтверждать; оказываться
personal|личный 
rub|тереть(ся); натирать
interrupt|прерывать
brush|щетка; кисть; чистить (щеткой) 
rope|веревка; канат; трос
alarm|тревога; поднять тревогу 
aware|сознающий, знающий
east|восток; восточный
terrible|страшный
tip|1) кончик; наконечник; 2) слегка касаться; 3) давать "на чай" 
spring|1) весна; реже 2) прыжок; (sprang ; sprung [sprAN])
protect|защищать
involve|вовлекать
whip|кнут; хлестать
lunch|ленч, второй завтрак
reporter|репортер 
bell|звонок; колокол 
suspect|подозревать; полагать, предполагать
evil|зло; порок; злой
booth|будка; киоск; палатка
tone|тон (голоса и т.п.)
chamber|комната; палата (торг., мед.); кабинет; камера 
shower|ливень; душ; обилие; литься; заваливать 
examine|рассматривать; исследовать; экзаменовать 
sweet|сладкий; милый 
choice|выбор 
palm|1) пальма; 2) ладонь
assume|допускать
obviously|очевидно
traffic|движение (уличное, ж/д); транспорт 
hook|крюк; цеплять крючком; застегивать на крючок 
wrist|запястье; манжета
cabin|кабина; каюта
enemy|враг, неприятель
smoke|дым; дымить(ся)
silver|серебро; серебрянный
pipe|труба; трубопровод; трубка (курительная) и др.
normal|нормальный
chase|погоня; гнаться (за)
secretary|секретарь 
discover|узнавать; обнаруживать; открывать
wine|вино 
gasp|задыхаться
fail|потерпеть неудачу; не суметь; провалить(ся) на экзаменах
dive|ныряние (в воду); внезапное движение, рывок; нырять
breathe|дышать
moon|луна
dissolve|растворять(ся)
sex|пол, секс; половой, сексуальный
ace|очко; карт. туз; ас; главный козырь; лучший; высшая оценка 
newspaper|газета
twice|дважды; вдвое
choose (chose ; chosen|['Couzn]) выбирать; избирать; предпочитать 
float|плавать (на поверхности); парить, плыть 
uncle|дядя 
aim|цель; целиться 
public|публика; общественный; публичный; народный 
section|секция; отдел 
dangerous|опасный 
shine|блеск, свет; (shone; shone ) сиять; блестеть
gentleman|джентльмен; господин; (мн. ч. gentlemen) 
song|песня 
effect|результат 
nearby|близлежащий, соседний;поблизости, рядом 
flower|цветок
faint|слабый; ослабевать
pat|похлопывание, шлёпанье; похлопывать; разг. кстати 
confuse|смущать
visit|посещение; посещать
film|пленка; фильм 
future|будущее 
queen|королева 
stomach|желудок
demand|требование; нужда; требовать; нуждаться 
department|отдел
boot|ботинок; сапог 
trap|капкан; западня; ловушка; поймать в ловушку 
mess|беспорядок; путаница; производить беспорядок 
battle|битва, сражение, бой
photograph|фото, снимок; фотографировать, снимать
impossible|невозможный
mad|сумасшедший 
guest|гость
joke|шутка; шутить
taste|вкус; склонность; (по)пробовать (на вкус) 
forth|вперед; впредь
fist|кулак 
squeeze|сжимать; втискивать(ся), протискиваться 
especially|особенно 
stun|оглушать, ошеломлять
wooden|деревянный 
leather|кожа (выделанная)
slap|хлопать, шлепать
purpose|цель, намерение
band|1) лента, полоска; 2) группа (людей); банда; оркестр
tough|жесткий; стойкий 
vehicle|любое средство передвижения (автомобиль и т.п.)
focus|фокус; перен. центр; фокусировать; сосредотачивать
usually|обычно 
video|видео
luck|удача, счастье 
iron|железо; железный
effort|усилие, попытка
duty|долг; пошлина 
chick|цыпленок; птенец; chicken цыпленок; курятина (еда)
waste|бесполезная трата; потери; тратить зря
fresh|свежий; новый; чистый
glare|ослепительный свет; свирепый взгляд; ослепительно светить; свирепо смотреть
swear (swore ; sworn|[swLn]) клясться; присягать; ругать(ся) 
beauty|красота; красавица
tongue|язык 
fun|веселье, забава, шутка
cable|канат; трос; кабель
backward|обратный; отсталый;(тж. ~s) назад; наоборот
honour|бр. = honor ам. (1:13) честь, слава; почет; почитать
cash|наличные деньги
alien|чужестранец, иностранец; чужестранный; чуждый 
detail|подробность, деталь
lab|лаборатория, разг. сокр. от laboratory  
director|директор
hardly|едва; едва ли 
clerk|клерк, служащий
fence|забор, изгородь; огораживать
crime|преступление 
strip|полоска, лента; сдирать; раздевать(ся); снимать 
familiar|знакомый 
local|местный 
price|цена 
signal|сигнал; знак; сигнализировать 
giant|великан, гигант, титан; громадный, гигантский 
chain|цепь; цепочка; узы; последовательность; сковывать
smart|толковый; умный
various|различный
pants|брюки; трусы 
opposite|противоположность; противоположный; prep,против, напротив
breathing|дыхание 
object|1) предмет; вещь; цель; 2) возражать 
grass|трава 
apparently|очевидно
lobby|прихожая, кулуары
dial|циферблат; диск телефона; набирать номер, звонить 
naked|обнаженный
intend|намереваться
honey|мед; разг. милая, милый, дорогой, душечка 
support|поддержка; поддерживать; помогать
blond(e)|блондин; (-e) блондинка; белокурый 
print|отпечаток; след; шрифт; печатать; публиковать 
suck|сосать; всасывать 
garage|гараж 
pattern|образец; модель
clutch|когти; лапы; хватка; схватить(ся); зажать, стиснуть
faith|вера, доверие 
sand|песок 
tail|хвост и др. 
student|студент
swim (swam ; swum|[swAm]) плыть, плавать
dirty|грязный 
forehead|лоб 
strength|сила; прочность
anger|гнев 
laughter|смех, хохот
distant|отдаленный 
subject|предмет (учебный); тема, предмет (разговора)
remind|напоминать
garden|сад 
forest|лес 
camp|лагерь 
snake|змея 
echo|эхо; отражение; отражаться; вторить
partner|партнер
military|военный
client|клиент 
everywhere|везде, (по)всюду
skull|череп; устн. голова
exchange|обмен; менять(ся)
program|= programme (8:1) программа; план; планировать
usual|обыкновенный
restaurant|ресторан 
equipment|снаряжение; оборудование
hug|крепкое объятие; крепко обнимать 
difficult|трудный 
till|до; в отриц. предл. не раньше; (до тех пор) пока 
buck|доллар и др.
react|реагировать
rich|богатый; плодородный
swallow|1) ласточка; 2) глоток; глотать
curtain|занавеска; занавес; занавешивать
bury|хоронить; зарывать
stream|поток; течение; ручей; течь, вытекать, струиться 
president|президент
wanna|разг. = want to – хотеть (чего-либо)
soul|душа; дух; сущность
duck|1) утка; 2) быстро наклоняться; увертываться; нырять
bolt|засов, задвижка; шпингалет; болт; запирать на засов и др.
golden|золотой 
pressure|давление; нажим
indicate|указывать 
bay|залив, бухта
startle|испугать; поразить, удивить
avoid|избегать; уклоняться (от)
breast|грудь
condition|условие; состояние; обусловливать, определять
sip|глоток; немного; пить мал. глотками; пробовать
code|кодекс; код; кодировать
account|счет; отчет; причина; считать, признавать
tremble|дрожать
data|данные, факты 
mutter|бормотать
anywhere|где-нибудь (в вопр.); нигде (в отриц.); где угодно (в утверд.)
library|библиотека 
welcome|париветствие; приветствовать 
prison|тюрьма 
kneel (knelt|, kneeled [nJld]; knelt, kneeled) становиться на колени 
lake|озеро
instant|мгновение; немедленный; растворимый 
airport|аэропорт 
cast (cast; cast)|бросать, кидать; лить, отливать (металл)
indeed|в самом деле
claim|требование; утверждение; требовать; заявлять
target|цель, мишень 
pin|булавка; шпилька; брошка; скалывать, скреплять; прикалывать
respect|уважение; отношение; уважать
art|искусство 
easily|легко, без труда
attorney|адвокат; юрист
fair|прекрасный; чистый; белокурый; честный, справедливый
muscle|мышца, мускл
horror|ужас 
bare|голый, обнаженный 
beast|зверь; животное
pleasure|удовольствие
puzzle|вопрос, ставящий в тупик; загадка; озадачивать, смущать
grave|1) могила; 2) серьезный, важный 
trace|след; прослеживать
excite|возбуждать, волновать
length|длина 
mount|холм, гора
risk|риск; рисковать
ocean|океан 
energy|энергия,
amaze|изумлять, поражать
envelope|обертывать, окутывать; n оболочка
contain|  вмещать 
audience|публика; зрители
stumble|спотыкаться; запинаться 
leader|руководитель; лидер
difference|разница 
barrel|бочка; баррель= 159 л.
wonderful|удивительный, замечательный 
demon|= daemon (2,3:1) демон, сатана, дьявол; дух 
besides|кроме;кроме
dirt|грязь
accident|случай; авария
steady|твердый, устойчивый; делать(ся) устойчивым 
interior|внутренность; внутренний 
mission|миссия, делегация; призвание; поручение 
victim|жертва
absolutely|абсолютно; совершенно
patient|пациент, больной; терпеливый 
occur|случаться, происходить; встречаться; приходить на ум 
alright|= all right удовлетворительный;ладно!, согласен!
receive|получать
split (split; split)|раскалывать(ся); расщеплять(ся); трещина, щель
practice|тренировка; (practise бр. = practice ам.) упражнять(ся)
upstairs|вверх (по лестнице), наверх; наверху 
panel|щит (управления); панель; список, перечень
ease|покой; успокаивать
advance|продвижение; успех; прогресс; делать успехи
couch|диван, кушетка 
correct|правильный; исправлять
firm|фирма; твердый, крепкий; стойкий; решительный 
smooth|гладкий, ровный; сглаживать 
powerful|мощный 
slight|легкий, слабый 
scan|сканировать; бегло просматривать; внимательно смотреть
credit|вера, доверие
unit|единица; целое; единица (измерен.); секция; блок; воен.: часть
glove|перчатка; надевать перчатку 
claw|коготь; клешня; груб. рука, лапа; царапать; вцепиться 
gear|механизм; передача (скорость); приспособления 
engineer|инженер; создавать, проектировать
awake (awoke ;| awoke, awoken [q'woukn]) будить; просыпаться
ought|(долженствование) следует, следовало бы, должен 
stack|стог; куча, груда; множество; складывать в кучу 
flow|течение, поток (тж. перен.); течь, литься; струиться 
whom|кого; которого
belong|принадлежать 
ancient|древний; античный
decision|решение 
direct|прямой; направлять; руководить, управлять 
cap|кепка, шапка; верхушка
highway|шоссе 
exist|существовать, жить
oil|нефть; смазывать
monster|чудовище
missing|отсутствующий
temple|1) храм; 2) висок
spit (spat; spat ;|уст. также spit; spit) плевать(ся); брызгать слюной; моросить, накрапывать (о дожде) 
ma|мама (сокр. от mamma)
chin|подбородок 
priest|священник 
extend|протягивать; простирать(ся); распространять
sake for the|~ of, for smb.'s ~ для/ради кого-либо 
magazine|журнал
mass|масса, множество
ticket|билет; ярлык 
weather|погода 
damage|вред, повреждение; ущерб; повреждать, портить 
spill|(бр. spilt, spilt , ам. spilled, spilled [spIld]) проливать(ся); рассыпать(ся); разг. сбросить, вывалить; проболтаться
refuse|отказывать(ся)
vision|зрение; зрелище 
event|событие; случай 
flashlight|карманный фонарь
manager|менеджер
presence|присутствие
drawer|ящик (стола, комода)
thumb|большой палец (руки); выступ; захватывать; уминать
favour|бр. = favor ам. (1:12) благосклонность; благоволить 
march|1) March март; 2) марш, переход; маршировать
create|творить, создавать
jam|1) затор, давка; набивать(ся) битком; 2) варенье, джем 
danger|опасность 
respond|отвечать; отзываться, реагировать 
summer|лето 
assistant|ассистент 
massive|массивный
century|век, столетие 
shatter|разбить(ся) вдребезги; расстраивать (здоровье)
female|женский; женщина
strain|натяжение; напряжение; натягивать(ся); напрягать(ся)
justice|правосудие 
project|1) проект, план; 2) проектировать 
emergency|крайняя необходимость; критическое положение
customer|покупатель; клиент
pad|подушка; блокнот 
collapse|обвал; крах; рушиться; терпеть неудачу/крах 
arrest|арест; арестовывать
trick|хитрость, обман; фокус, трюк; обманывать 
series|  ряд; серия 
electric(al)|электрический
bug|жук, насекомое; потайной микрофон; вести тайн наблюд.
lap|1) колени; 2) жадно пить, лакать
rail|ограда; перила; поручень; рельс; разг. ж/д дорога
sixty|шестьдесят 
porch|крыльцо; веранда
screw|винт и др.; завинчивать; вращать; выжимать и др. 
cliff|(отвесная) скала, утес
pump|насос; накачивать, качать; выталкивать 
design|замысел; проект, план; задумывать; проектировать 
response|ответ; отклик
fellow|парень, приятель
supply|снабжение; запас; снабжать; поставлять 
mill|мельница; фабрика
alley|узкая улица; аллея 
style|стиль; менера; мода
tube|труба; тюбик; метро (в Лондоне) 
bowl|1) миска; чашка; кубок; ваза; 2) шар (в играх); играть в шары
orange|апельсин; оранжевый
perfectly|совершенно, вполне; превосходно 
shotgun|пулемет 
necessary|необходимый 
pink|розовый 
obvious|очевидный, явный
village|поселок; деревня 
policeman|полицейский; (мн. ч. policemen) 
closet|амер. чулан; стенной шкаф 
result|результат, следствие; происходить в результате 
regard|внимание; ~s привет; смотреть (на); считать; касаться
possibly|возможно
hiss|шипение; свист; шипеть; свистеть 
sidewalk|тротуар 
stride (strode ; stridden|['strIdn]) шагать (большими шагами); большой шаг
breakfast|завтрак 
trunk|ствол; туловище; дорожный сундук; плавки ~s 
stranger|чужестранец, нездешний; незнакомец, посторонний
dude|парень; тип; пижон
employ|давать работу, нанимать; применять; employee рабочий, служащий; employer [Im'plOIq] работодатель, предприниматель
branch|ветка; рукав; отрасль; филиал, отделение 
enormous|громадный
site|  место, участок
lamp|лампа 
butt|1) торец; рукоятка (пистолета, меча); ударять головой, бодать
cage|клетка; жарг. тюрьма
college|колледж
terrify|ужасать, внушать страх; запугивать
ruin|гибель; крушение; ~s развалины, руины; разрушать, губить
totally|вполне, совершенно, полностью
wander|бродить, скитаться
bore|1) скука; зануда (человек); надоедать; 2) сверлить
manner|способ; манера
yesterday|вчера 
produce|производить
hood|капюшон; чехол; капот
cost (cost; cost)|стоить; цена, стоимость 
nail|гвоздь; забивать гвозди; прибивать гвоздями
discuss|обсуждать
shell|раковина; оболочка
whistle|свист; свистеть
dock|1) док; вводить в док; 2) скамья подсудимых 
feature|особенность; ~s черты лица; быть характ. чертой 
dining|в составный словах dining-table обеденный стол и т.п. 
buzz|жужжание; гул (голосов); жужжать; гудеть 
heaven|~(s) небо, небеса; как междометие: (о) боже!; черт возьми!
upset (upset; upset)|расстраивать, огорчать; расстроенный 
steam|пар; запотевать
bunch|связка; пучок; букет; гроздь; собирать, связывать
basement|основание; подвал; (полу)подвальный этаж
junior|младший 
scar|шрам, рубец; оставлять шрамы; перен. оставл. глубок. следы
bleed (bled; bled)|кровоточить
nature|природа; натура
curve|кривая (линия); изгиб, поворот; изгибать(ся)
official|чиновник; служебный; официальный 
taxi|такси
court|1) суд; 2) двор; площ. для игр; корт
greet|приветствовать; здороваться 
silently|молча; тихо
rough|грубый; неровный; резкий, суровый (о природе);грубо 
explosion|взрыв
piss|моча; мочиться
replace|ставить/класть обратно; заменять, замещать
drunk|пьяный, опьяненный
process|процесс; течение; ход развития; подвергать обработке
curse|проклятие; ругательство; проклинать; ругаться
jungle|джунгли 
seal|1) печать; запечатывать; скреплять печатью; 2) тюлень
dump|свалка; сваливать (в кучу); выбрасывать 
particular|частность; особый; частный; отдельный
sport|спорт 
reaction|реакция
cook|повар; кухарка; готовить, варить
stir|шевелить(ся), двигать(ся); мешать, размешивать; волновать
intelligence|ум
embarrass|смущать(ся)
seek (sought; sought )|искать, разыскивать; стремиться (к) 
pen|ручка; перо 
survive|пережить; выжить
central|центральный; главный
staff|штат (служащих); штаб (воен.)
crouch|присесть; пригнуться; низко кланяться 
rabbit|кролик 
creep (crept; crept)|ползать
castle|замок, дворец 
observe|наблюдать
arrange|располагать
scratch|царапина; скрип; царапать(ся); скрести(сь); чесать(ся)
bat|1) летучая мышь; 2) бита
range|ряд, линия; диапазон
murmur|журчание; бормотание; шептать, бормотать
towel|полотенце 
cough|кашель; кашлять
hire|наем; прокат; нанимать; снимать; брать на прокат
swell (swelled|; swollen swouln]) раздуваться, набухать; опухать
medical|медицинский
male|мужской; мужчина
heel|пятка; каблук; пристукивать каблуками; следовать по пятам
separate|отделять(ся); разделять(ся); отдельный
cheer|одобрит. или приветств. восклицание; ура; приветствовать
aircraft|самолет, самолеты; авиация (мн. ч. без измен.) 
convince|убеждать; уверять
forever|навсегда, навеки
pitch|бросок; подача и др; бросать, кидать и др.
upper|верхний; высший 
treat|удовольствие; обращаться (с); относиться (к); лечить; угощать
instantly|немедленно
knowledge|знание, знания
rat|крыса 
cave|пещера; полость; выдалбливать 
degree|степень; градус
dodge|обман, уловка, хитрость; увертываться; увиливать
connect|соединять(ся)
prisoner|заключенный
scramble|карабкаться; взбираться, пробираться 
visible|видимый; явный 
pretend|притворяться
plain|равнина; очевидный
vanish|исчезать
shelf|полка, (мн. ч. shelves)
player|игрок; актер 
universe|мир, вселенная
script|сценарий 
flicker|мерцание; мерцать
weird|таинственный
balance|весы; равновесие; взвешивать; балансировать
language|язык; речь
blank|пустой, незаполненный; пустое, свободное место; пробел
issue|издание, выпуск; издавать, выпускать 
weak|слабый 
surely|конечно; несомненно, наверняка 
entirely|полностью, совершенно 
shield|щит; перен. защита; прикрывать, защищать 
marine|мор. флот; солдат мор. пех.; морской 
overhead|наверху, над головой
solid|твердый; прочный
sail|парус; плавание (на кораб.); плыть (на кораб.); парить (в возд.)
stagger|шататься
elbow|локоть; (резкий) изгиб (реки, дороги); подлокотник 
pit|яма, впадина; шахта; котлован; окоп; рыть, делать ямы 
needle|игла, иголка 
mister|мистер, господин
eleven|одиннадцать 
platform|платформа; перрон; помост; сцена 
mostly|главным образом
rapidly|быстро 
egg|яйцо 
dare|сметь, отваживаться
owner|владелец, хозяин
suffer|страдать
hammer|молоток; вбивать, прибивать; колотить
thunder|гром; греметь
corpse|труп 
stroke|1) удар; взмах; 2) гладить, поглаживать 
heavily|тяжело; сильно
clip|зажим, скрепка; зажимать; скреплять 
total|целое; сумма; общий
helmet|шлем; каска 
bench|скамейка 
source|источник; начало
scatter|разбрасывать
eventually|в конечном счете, в конце концов 
spray|1) ветка, побег; 2) брызги; распылитель; обрызгивать
trade|торговля; торговать
mix|смешивать(ся)
descend|спускаться, опускаться, понижаться;  переходить
sonny|разг. сынок 
boom|гул, рокот; бум, быстрый подъем; греметь; быстро расти
crush|раздавить; (с)мять; сокрушить, уничтожить 
relief|облегчение; помощь 
senator|сенатор
trigger|защелка; спусковой крючок, курок, механизм 
insist|настаивать 
deliver|доставлять, передавать; вручать 
conference|конференция; совещание 
terror|ужас, страх; террор
jar|1) резкий звук; дребезжание; дребезжать; 2) банка
argue|спорить; утверждать, доказывать 
require|требовать(ся)
worst|наихудший;хуже всего; наихудшее 
recall|вспоминать; отзывать
halt|остановка; останавливать(ся) 
badly|плохо, дурно; очень; сильно 
collect|собирать(ся); коллекционировать 
rage|ярость; злиться 
blanket|одеяло 
tray|поднос; лоток 
drip|капать; стекать
limit|граница, предел; ограничивать 
fan|1) веер; вентилятор; обмахивать; 2) болельшик, фанат 
attach|прикреплять
upward|направленный вверх;вверх, (тж. ~s) 
dim|тусклый; смутный, неясный; делать тусклым; затенять 
deputy|депутат; заместитель, помошник 
sad|печальный, грустный 
flick|щелчок; разг. кино, фильм; слегка щелкнуть; смахнуть 
carpet|ковер; устилать
expose|выставлять; подвергать; разоблачать 
sob|рыдание, всхлипывание; рыдать, всхлипывать
strap|ремень, полоска; завязка, бретелька; стягивать ремнями
natural|естественный
curious|любопытный
starling|1) скворец; 2)
stern|строгий, суровый 
comment|комментарий; комментировать 
bounce|подпрыгивать; отскакивать; вскакивать 
threaten|угрожать
lovely|прелестный 
waiter|официант 
moan|стон; стонать
exhaust|истощать, изнурять; исчерпывать
nervously|нервно 
likely|вероятный;вероятно
sailor|моряк, матрос 
concentrate|сосредотачивать(ся); концентрировать(ся)
character|характер; фигура, личность; образ, лицо 
defense|защита, оборона
term|срок, период; семестр; учебн. четверть; термин
random|случайный, произвольный, выбранный наугад
rose|роза 
slope|уклон; склон, откос; иметь наклон; клониться; наклонить
abruptly|внезапно; резко, грубо 
fashion|образ, манера; фасон; стиль; придавать вид, форму 
awful|ужасный 
glimpse|мелькание; мимолетное впечатление; мельком взглянуть
describe|описывать 
extra|дополнительный
purse|кошелек; дамская сумочка; деньги, богатство; морщить(ся)
fully|полностью
squad|группа, команда 
peace|мир; покой 
mail|почта; посылать по
briefly|кратко 
spirit|дух, душа; натура
nowhere|нигде; никуда
holy|святой; священный 
thrust (thrust; thrust)|толкать; тыкать; просовывать; толчок 
operate|работать, действовать; управлять
otherwise|иначе
current|струя; течение, ход; ток (электр.); текущий 
groan|стон; стонать
stain|пятно; позорящ. факт; пятнать; пачкать(ся); позорить
horn|рог; горн; рупор
rocky|скалистый
admiral|адмирал 
diamond|алмаз
cock|петух; заводила; взведенный курок; поднимать
waist|талия 
merely|только, просто
chuckle|хихикать
despite|1) несмотря на, вопреки; 2) злоба; уст. оскорблять
concrete|1) конкретный; 2) бетон 
chip|щепка; стружка; обломок; откалывать; строгать
common|общий; общепринятый; простой, обыкновенный 
magic|волшебный 
folk|, чаще folks люди, народ; родня, родные; друзья 
dart|дротик;  рывок, бросок; метать; помчаться стрелой
professional|профессионал; профессиональный 
fault|ошибка; вина 
avenue|аллея; проспект, авеню
devil|дьявол, черт 
tuck|засовывать, прятать
brand|сорт, качество 
tense|1) грам. время; 2) натянутый; натягивать(ся)
chew|жвачка; жевать;
bye, bye-bye|разг. от goodbye пока!, всего! 
emotion|волнение; чувство, эмоция 
ash|зола, пепел; прах 
suitcase|чемодан 
bound|1) граница, предел (чаще ~s); ограничивать; 2) прыжок; прыгать; 3) обязанный, вынужденный
wolf|волк, (мн.ч. wolves) 
trailer|прицеп 
cockpit|кубрик, кокпит (мор.); кабина (летч.) 
tea|чай 
unable|неспособный
national|национальный
determine|решать(ся); определять, устанавливать
hungry|голодный
quit|покидать, оставлять; прекращать (работу); увольнение
register|журнал (для записей); регистрировать(ся) 
announce|объявлять
worker|рабочий 
sunlight|солнечный свет
jail|тюрьма 
bride|невеста 
plenty|(из)обилие
grunt|хрюканье; ворчание; хрюкать; ворчать; бурчать 
proud|гордый 
adjust|приводить в порядок; улаживать; приспосабливать 
gift|подарок, дар 
satisfy|удовлетворять; доставлять удовольствие
grasp|хватка; понимание; схватывать; охватить, понять 
angel|ангел 
hristmas|Рождество
owe|задолжать; быть должным, обязанным 
guide|проводник, гид; советчик; путеводитель; вести; направлять
disturb|беспокоить, мешать;
reflect|отражать(ся)
united|соединенный
willing|готовый (сделать что-л.); охотно делающий 
title|заглавие, название
blame|вина; упрек; винить, порицать 
interview|беседа, интервью; интервьюировать 
gut|кишка; потрошить; опустошать, грабить 
howl|вой; выть 
mouse|мышь, (мн. ч. mice)
beg|просить, умолять 
vast|общирный, громадный
cheap|дешевый;дешево
bike|велосипед 
model|модель; образец 
impress|отпечатывать; производить впечатление; внушать 
gang|группа, бригада; банда
automatic|автоматический
haul|тянуть, волочить; буксировать; перевозить 
patrol|патруль; патрулировать 
lawn|газон, лужайка 
criminal|преступник; преступный; уголовный 
comfort|комфорт; утешение; утешать; успокаивать 
legal|законный; легальный
ladder|лестница (приставная); трап и др.
physical|физический 
rate|норма; расценка; скорость; разряд; класс; оценивать; считать
rumble|грохот; греметь
troop|группа людей, отряд
device|устройство; механизм; прибор; способ, средство 
bark|лай; лаять; рявкать
comfortable|удобный 
mayor|мэр 
hunt|охотиться, ловить 
joint|место соединения, стык; сустав; объединенный, общий 
provide|снабжать;
tumble|падение; упасть, свалиться; обрушиваться; валяться 
deeply|глубоко; сильно
snatch|хватать(ся); вырывать, выхватывать; набрасываться 
background|задний план; фон; происхождение; подготовка
appreciate|ценить; высоко ставить; понимать ценность 
possibility|возможность
whale|кит; разг. нечто выдающееся (по велич. или качеству) 
hunter|охотник 
unlock|отпирать
monkey|обезьяна 
fourth|четвертый 
receiver|получатель; (радио)приемник; телеф. трубка 
nerve|нерв; нервозность; разг. наглость, нахальство
hip|бедро 
pot|горшок; кастрюля; банка; консервировать 
launch|начинать; предпринимать; запускать; спускать (судно)
joy|радость, веселье 
authority|власть; ~s власти; авторитет 
unday|воскресенье 
shade|тень; оттенок; абажур; затемнять, заслонять 
gain|прибыль, выигрыш; ~s доходы; получать; приобретать
motel|мотель
string|веревка; струна; ряд
widen|расширять(ся) 
jaw|челюсть; ~s рот; пасть
briefcase|портфель 
choke|удушье; душить; задыхаться; поперхнуться; заглушать
meter|= metre (43:1) метр; счетчик, измеритель
hum|жужжание; гудение; жужжать; гудеть 
meat|мясо; устн. пища 
brick|кирпич; кирпичный
identify|отождествлять; опознавать 
recover|получать обратно; обретать снова; выздоравливать
bush|куст; кустарник 
drain|дренаж; водосток; перен. истощение; осущать; истощать
abandon|оставлять,
clothing|одежда; платье
fry|жарить 
protest|протестовать; протест 
bump|столкновение, удар; шишка; ударяться, налетать 
original|подлинник, оригинал; первоначальный; подлинный
professor|профессор 
museum|музей
connection|соединение
content|1) содержание; ~s содержимое; 2) удовлетворение; довольный; удовлетворять
lane|дорожка, тропинка; переулок; проход между рядами,
licence|бр. = license ам. (1:22) разрешение, лицензия; разрешать 
particularly|особенно
county|округ (амер.); графство (брит.) 
cigar|сигара 
candy|конфет(-а,-ы)
port|порт, гавань 
eyebrow|бровь 
rattle|треск, грохот; трещать, греметь 
shiver|дрожать, трястись
shriek|пронзительный крик; визжать, вопить 
beard|борода; борода и усы
assure|уверять, заверять
stock|запас; снабжать 
coast|морской берег; побережье; плавать вдоль побережья 
hatch|крышка люка; сленг пасть; замышлять, готовить (тайно)
disgust|отвращение; вызывать отвращение, возмущение 
valley|долина  
lick|лизать, облизывать; слегка касаться; разг. бить, колотить 
rack|1) вешалка; полка; подставка; класть на полку; 2) дыба; перен. пытка; пытать, мучить и др.
broad|широкий; свободный; явный;широко; свободно; вполне
lack|отсутствие; недостаток; недоставать 
patch|заплата; клочок; пятно; латать; покрываться пятнами 
opinion|мнение, взгляд
growl|рычать; ворчать, огрызаться
suite|апартаменты, номер-люкс
pray|молить(ся); умолять
ugly|уродливый, безобразный
secure|спокойный, уверенный; безопасный; охранять; закреплять
increase|возрастать, увеличивать(ся), усиливать(ся) 
jury|присяжные; жюри
straighten|выпрямлять(ся); приводить в порядок; исправлять(ся) 
jeep|авт. джип 
activity|деятельность
dusk|сумерки 
skip|прыжок, скачок; прыгать, скакать; пропускать 
locate|определять местонахождение; располагать; размещать
driveway|дорога, проезд
motor|мотор; двигатель
wallet|бумажник 
gentle|мягкий; нежный
package|сверток; пакет
sleeve|рукав; втулка; муфта
collar|воротник; ожерелье
rag|1) тряпка, лоскут; 2) жарг. скандал; дразнить
opportunity|удобный случай; благоприятная возможность
curl|локон, завиток; виться; завивать(ся) 
drill|1) сверло; сверлить; 2) тренировка; тренировать 
tightly|прочно; напряженно; строго; крепко 
seventy|семьдесят
hero|герой 
poke|совать, толкать, тыкать; разг. ударить кулаком 
breeze|легкий ветерок, бриз
market|рынок; торговля; торговать
friendly|дружеский 
teacher|учитель 
slice|ломтик (хлеба, мяса и т.п.); часть, доля; резать ломтями
wildly|дико; буйно 
shaft|древко (копья и т.п.); стрела; копье; луч (света) и др. 
rescue|спасение; спасать
cabinet|сервант; шкафчик; устн. кабинет; будуар 
downstairs|вниз (по лестнице); внизу; в нижнем этаже
innocent|невиновный
belly|живот 
ankle|лодыжка, щиколотка
marshal(l)|воен. маршал; амер. судебный исполнитель 
scientist|ученый 
reverse|противоположное; противоположный; поворачивать обратно 
aturday|суббота 
material|материал; ткань, материя; материальный
knot|узел; завязывать, связывать
shudder|дрожь; содрагание; вздрагивать; содрагаться 
reality|действительность
mood|настроение 
rent|арендная плата; арендовать; сдавать в аренду
whoever|кто бы ни; любой
investigation|расследование; исследование (научное); изучение
tent|палатка 
theatre|бр. = theater ам. (1:1,4)
farm|ферма 
knight|рыцарь 
honest|честный 
dumb|немой; бессловесный; сленг: глупый, тупой 
research|исследование
limp|1) хромота; хромать; 2) мягкий, нежный; вялый 
fling (flung; flung )|бросать, метать, швырять; ринуться
winter|зима 
percent|амер. шк. разг. выводить отметку на письм. экзамене
appearance|появление
depend|зависеть 
bean|боб  
sharply|резко 
cord|веревка, шнур 
nightmare|кошмар; страшный сон; перен. ужас 
tilt|наклон; наклонять(ся); опрокидывать, выворачивать 
amount|количество; сумма
dot|точка; пятнышко; крошка; ставить точки; усеивать
fuel|топливо, горючее; заправлять топливом 
neighbo(u)rhood|соседство, близость; район, округ 
speech|речь, выступление
stall|стойло; ларек; прилавок; ставить в стойло; отводить место
progress|прогресс, развитие, успехи; развиваться 
torch|факел; фонарик; освещать факелами 
tool|(рабочий) инструмент; перен. орудие 
sandwich|сандвич 
cart|телега; повозка 
statement|заявление; утверждение 
shave|бритье; (shaved; shaved, shaven) брить(ся)
handsome|красивый 1.102 1981  nut орех; жарг. башка, "котелок"; псих, чокнутый (чаще ~s)
channel|пролив; канал (тж. перен., напр. TV) 
furious|взбешенный, яростный; неистовый 
lightning|молния 
route|маршрут, путь, курс
relieve|облегчать;
pillow|подушка 
aunt|тетя 
halfway|на полпути
invite|приглашать 
somewhat|отчасти, до некоторой степени, несколько
bullshit|разг. чушь, ерунда
request|просьба; просить
proper|правильный; подходящий; присущий, свойственный 
plunge|нырять, окунать(ся)
contract|договор; заключать договор 
desperate|отчаянный; безнадежный; ужасный 
footstep|шаг; ~s шаги
truly|правдиво, искренне
rubber|резина; ластик 
wagon|повозка; фургон
rocket|ракета; выпускать ракету; взлетать 
fighter|боец, борец 
tug|тянуть с усилием; дергать изо всех сил 
item|(отдельный) предмет, вещь (из списка); пункт, параграф
embrace|объятие; объятия; обнимать(ся)
lover|любитель; любовник, возлюбленный; ~s влюбленная парочка
brilliant|блестящий 
waitress|официантка
splash|брызги, плеск; брызгать(ся), плескать(ся) 
structure|сооружение, строение; структура, устройство 
desperately|отчаянно; безнадежно; крайне, очень 
poison|яд; отравлять
flood|наводнение; поток; затоплять; наводнять
asshole|руг. задница
peel|кожура, корка; снимать кожуру; облезать (о краске, коже) 
according|~ to согласно, в соответствии с 
blaze|пламя; перен. вспышка; пылать, гореть (тж. перен.) 
goodbye|до свидания!; прощай(те)! 
height|высота; вершина; рост (чел. и т.д.); высшая степень
swirl|кружение, водоворот; кружить(ся) в водовороте; обвивать
retreat|отступление, убежище, приют; отступать, уходить
insert|вставлять 
streak|полоска; жилка; проводить полосы; разг. мелькать 
pure|чистый; без примеси
technician|техник 
shore|берег (моря, озера)
prefer|предпочитать
wade|брод; переходить вброд; пробиваться, преодолевать
underneath|под;вниз; внизу; снизу 
darling|дорогой, любимый
amber|янтарь 
introduce|вводить; представлять, знакомить 
closely|близко, тесно
milk|молоко; доить 
theory|теория 
lid|крышка, колпак; веко
walker|ходок, тот кто идет, гуляет и т.п. 
sword|меч; шпага 
circumstance|обстоятельство; обычно употр. во мн. ч. ~s
measure|мера, мерка; измерять, мерить 
penny|1) брит. пенни, пенс; мн. ч.: pence (о сумме), pennies (об отд. монетах); 2) амер. монета в один цент
pierce|пронзать, протыкать, прокалывать; проникать 
dragon|дракон 
fog|густой туман; мгла; затуманивать(ся) 
console|утешать 
definitely|определенно
cling (clung; clung )|цепляться; прилипать; облегать (о платье)
inner|внутренний 
forgive (forgave ; forgiven|[fq'gIvn]) прощать 
remark|замечание; замечать, отмечать 
stab|закалывать; наносить удар (ножом и т.п.) 
harbour|бр. = harbor ам. (1:6) порт, гавань; убежище, приют 
calmly|тихо, спокойно
dash|рывок; тире, черточка; бросаться, мчаться 
commit|совершать (чаще дурное); поручать, вверять; подвергать
hawk|ястреб 
develop|развивать(ся
wedding|свадьба; венчание
gleam|слабый свет, проблеск; светиться, мерцать 
spell|(бр. spelt, ам. spelled) писать или произносить слово по буквам; spelling также правописание, орфография 
instrument|инструмент;
horizon|горизонт 
mud|грязь 
threat|угроза 
aboard|на борту; в вагоне; на борт; в вагон 
instruction|обучение; чаще: ~s инструкции, указания
spare|экономить; беречь; уделять; запасной, лишний 
silly|глупый 
pig|свинья 
toilet|туалет, уборная 
operator|оператор
seriously|серьезно
communication|сообщение; связь; ~s средства связи
vampire|вампир 
gene|биол. ген 
candle|свеча 
toy|игрушка 
estate|имущество, состояние; поместье; сословие 
marriage|женитьба, замужество, брак; свадьба 
complex|комплекс; сложный
passage|проход, проезд; коридор; отрывок (из книги и т.п.) 
crane|журавль; подъемный кран; вытягивать (шею); подним. краном
drum|барабан; бить в барабан; стучать, барабанить (пальцами) 
overlook|возвышаться над; смотреть сверху на
favourite|бр. = favorite ам. (1:7) любимец; любимый 
chill|холод; простуда; холодный; охлаждать
desire|(сильное) желание; желать, хотеть 
score|зарубка, метка; счет; делать метки; вести счет (в игре) 
executive|исполнительная власть; администратор; амер. служащий; правительственный 
mental|умственный 
loudly|громко 
loss|потеря; утрата; ущерб
link|звено (цепи); перен. связующ. звено; связь; соединять, связывать
sway|качать(ся)
deny|отрицать, отвергать; отказывать(ся)
steer|управлять (судном, авт. и т.п.); направлять
purple|пурпурный; фиолетовый, лиловый 
jeans|джинсы 
armour|бр. = armor ам. (1:10) доспехи; броня; покрывать броней
squint|косить (глазами); смотреть украдкой, коситься; щуриться
firmly|твердо; крепко
expensive|дорогой, дорогостоящий 
skirt|юбка; ~s пола; подол; идти по границе, окружать, окаймлять
hop|прыжок; прыгать
liquid|жидкость; жидкий
stiff|тугой; перен. напряженный; разг. вексель; босяк; зануда и др.
cowboy|ковбой 
sale|продажа, распродажа
arrow|стрела 
nasty|отвратительный, противный 
aisle|проход (между рядами в театре и т.п.)
windshield|щит от ветра
darken|затемнять; омрачать; темнеть 
siren|сирена (мифол.); сирена (сигнал) 
transfer|перемещение; перевод; перемещать
sniff|сопеть, фыркать; нюхать, обнюхивать 
sofa|софа, диван 
career|карьера, успех
navy|военно-морской флот
palace|дворец 
treasure|сокровище 
warrior|воин 
cream|сливки, крем; снимать сливки 
amuse|забавлять, развлекать
dangle|свободно висеть; болтаться; волочиться
escort|охрана; сопровождение; сопровождать 
coin|монета 
dean|декан; настоятель 
meal|еда; принятие пищи 
furniture|мебель
flush|краска, румянец (на лице); вспыхнуть, (по)краснеть 
bubble|пузырь(ок); дутое предприятие; пузыриться; кипеть 
famous|знаменитый 
twin|близнец; двойник 
insurance|страхование
soak|промачивать; пропитывать; впитывать 
ednesday|среда 
exterior|внешность, наружность; внешний, наружный 
shepherd|пастух; религ. пастырь
afford|иметь возможность; предоставлять, давать 
charm|обаяние, очарование; очаровывать 
ourselves|себя; сами
alert|тревога; бдительный; объявлять тревогу 
pride|гордость; предмет гордости; спесь, гордыня 
screenplay|сценарий 
filter|фильтр; фильтровать
freedom|свобода 
hover|парить, зависать (птица, самолет, облако); вертеться 
brake|тормоз; тормозить
establish|основывать, учреждать; создавать; укреплять 
outer|внешний, наружный
flee (fled; fled)|бежать, убегать, спасаться бегством 
university|университет
angrily|сердито, гневно
pill|пилюля 
rank|ряд, шеренга; звание, чин; категория; классифицировать 
silk|шелк; шелковый 
regular|регулярный; правильный; обычный 
screech|визжать; скрежетать
document|документ 
harm|вред, ущерб; вредить
statue|статуя 
spark|искра; искриться 
thigh|бедро 
eighty|восемьдесят 
due|должный; обязанный 
carve|вырезать, высекать 
blur|пятно; помутнение; пачкать; затуманивать 
conceal|скрывать
idiot|идиот 
mystery|тайна
slave|раб  
midnight|полночь 
guilty|виноватый, виновный
hut|хижина, лачуга  
ninety|девяносто 
sue|возбуждать дело; судиться
represent|представлять
remote|дальний, отдаленный; уединенный; маловероятный 
plus|плюс 
bruise|ушиб; ушибать 
clay|глина 
relationship|отношение, взаимоотношение; связь; родство 
neighbour|бр. = neighbor ам. (1:10) сосед, соседка  
tension|напряженность 
standard|стандарт, норма; образец; стандартный, типовой 
individual|личность, человек; личный, индивидуальный 
extremely|крайне, очень
accent|ударение; акцент; акцентировать 
toe|палец (на ноге); носок (башмака) 
affair|дело 
illuminate|освещать 
bust|1) бюст (скульпт.; женск.); 2) амер. халтура; взломать
swarm|толпа; толпиться
hurl|швырять; валить 
casually|случайно
medium|1) (мн. ч. media) средство, способ; media средства (информ. и т.п.); 2) средний 
melt|таять; плавить(ся)
access|доступ; подход 
impression|впечатление 
uncomfortable|неудобный 
perform|выполнять, совершать; играть, исполнять (роль и т.п.)
unconscious|не сознающий, бессознательный 
locker|(запирающийся) шкафчик, ящик (в раздевалке и т.п.) 
speaker|оратор; спикер 
visitor|посетитель, гость 
laser|лазер 
personally|лично, сам 
anxious|озабоченный; стремящийся (к), сильно желающий 
deserve|заслуживать 
unusual|необыкновенный
delight|удовольствие; доставлять наслаждение; восхищать
root|корень; перен. причина; укореняться; перен. внедрять(ся) 
proceed|продолжать(ся); возобновлять; происходить 
servant|слуга; прислуга
dish|блюдо (посуда); блюдо (кушанье); ~es посуда 
federal|федеральный
frantically|неистово
robe|халат, мантия 
whirl|вертеть(ся)
horrible|ужасный 
fumble|нащупывать, шарить; неловко обращаться (с) 
headlight|фара (автомобиля)
probe|исследовать 
invisible|невидимый 
etc|и т. д.; и т. п. 
tile|черепица; кафель; плитка; крыть черепицей, кафелем 
pleasant|приятный, милый 
mist|(легкий) туман; дымка
snarl|рычание; рычать 
staircase|лестница; лестничный марш 
balcony|балкон 
divorce|развод; разводиться
tourist|турист
joker|шутник; джокер (карт.) 
pole|1) столб; 2) полюс 
column|колонна; столб(ик)
confidence|доверие 
lad|парень, юноша 
tighten|сжимать(ся)
period|период, время
rob|грабить, обкрадывать 
fake|подделка, фальшивка; подделывать 
district|район, округ
curb|узда; сдерживание; обочина, край тротуароа 
pulse|пульс; биение; ритм; пульсировать 
expert|знаток, эксперт; опытный, знающий 
routine|заведенный порядок; рутина, шаблон 
terminal|конец; конечная станция; конечный 
neat|аккуратный; чистый
hers|её
flag|флаг
border|граница; граничить
society|  общество; объединение, ассоциация 
tour|поездка; турне; совершать путешествие 
rid (rid; rid)|избавлять(ся
winder|разг. сильный удар; нечто, захватывающее дух 
inform|информировать
violet|фиалка; фиолетовый
batter|сильно бить, колотить; разбиваться; биться 
silhouette|силуэт; вырисовываться (на фоне чего-л.) 
science|наука 
agency|агентство
grind (ground; ground )|молоть, толочь; шлифовать; разг. зубрить
doll|кукла; амер. разг. девушка
associate|соединять(ся 
minister|министр
former|прежний, бывший
incredible|невероятный
lunge|выпад, прыжок вперед; делать выпад, бросок вперед 
slump|резкое или внезапное падение; внезапно падать 
cautiously|осторожно
scrape|скоблить, скрести 
ill|больной, нездоровый 
headquarters|штаб; ставка, штаб-квартира 
pal|товарищ, приятель 
arch|арка, свод; дуга; перекрывать сводом; выгибать
dull|тусклый; тупой; скучный; утомлять; затуплять 
gale|сильный ветер, шторм
maintain|поддерживать
annoy|надоедать; раздражать
tune|мелодия; настраивать
hick|презр. провинциал, деревенщина 
schedule|расписание, график; составлять расписание; планировать
witch|колдунья, ведьма 
depth|глубина (тж. перен.)
skill|мастерство, искусство; талант, способности
hush|тишина; водворять тишину; заст. замолчать; Hush! Тише! 
lounge|гостиная; холл
coffin|гроб 
downward(s)|вниз
sneak|трус; красться; ускользать; школ. ябедничать 
crap|руг. глупость, вздор 
reflection|отражение; отблеск; размышление, раздумье 
robot|робот 
cargo|груз (судна, самолета)
alongside|рядом
log|бревно; полено; мор. лаг; работать на лесозаготовках
ambulance|машина скор. помощи; врачебный пункт 
exercise|упражнение; тренировка; упражнять(ся)
bartender|бармен, буфетчик 
hollow|пустота; яма; низина; полый;вогнутый;разг. полностью; делать полость; делать вогнутым 
advice|совет, советы 
argument|аргумент 
resume|возобновлять; брать обратно; резюме 
casino|казино 
rib|ребро 
native|уроженец; коренной житель; родной; местный 
attendant|служитель (в музее, театре и т.п.) 
habit|привычка; обычай 
confirm|подтверждать 
mumble|бормотать
senior|старший; пожилой человек; старший 
sprawl|растянуться; сидеть развалясь; раскидываться
excitement|возбуждение
bureau|бюро, комитет 
refer|отсылать; обращаться; ссылаться; иметь отношение 
spider|паук 
lightly|слегка; без усилий 
flap|махать, колыхать(ся)
trash|отбросы, хлам; разг. вздор, чушь, дрянь; очищать от мусора
attitude|позиция; отношение к
violently|неистово,
explanation|объяснение
shelter|приют, кров; укрытие; давать приют; укрывать(ся) 
engage|нанимать; занимать(ся)
throughout|через; повсюду, везде; в течение всего времени 
chunk|ломоть, большой кусок; крупная глыба; толстяк, толстуха
wreck|кораблекрушение; перен. крах; разрушать 
courtyard|внутренний двор (замка и т.п.) 
assault|нападение; штурм; нападать; штурмовать 
weep (wept; wept)|плакать, рыдать; запотевать (стекло и т.п.)
wink|моргать, мигать
riday|пятница 
hint|намек; намекать 
freak|причуда, каприз; урод, посмешище; капризничать
advantage|преимущество; выгода, польза 
wise|мудрый; разумный; амер. разг. осведомленный; заносчивый 
prop|подпирать
fleet|флот; флотилия; бухта, залив, ручей; быстро протекать
whenever|всякий раз когда; когда бы ни 
huddle|прижиматься друг к
crate|ящик, контейнер 
deadly|смертельный 
impact|удар, столкновение; воздействие; плотно сжимать 
studio|студия
unknown|неизвестный 
pearl|жемчуг, жемчужина 
hull|пустой стручок; кожура, шелуха; кузов, каркас, корпус, фюзеляж
recently|недавно
weekend|суббота и воскресенье; конец недели, уикенд 
scale|шкала; масштаб; ~s весы; взбираться 
sequence|последовательность, ряд; последствие 
outta|= out of вне, за пределами чего-л.
bandage|бинт, повязка; бинтовать, перевязывать 
shame|стыд, позор; a ~ разг. обида, жалость; стыдить
urge|побуждение, сильное желание; побуждать, убеждать
baseball|бейсбол 
chopper|нож (мясника); колун; сечка; билетный контролер 
spy|(мн. ч. spies) шпион; шпионить, следить 
onday|понедельник 
intense|сильный; интенсивный, напряженный 
accompany|сопровождать, провожать; аккомпанировать 
torture|пытка; пытать
birthday|день рождения 
champagne|шампанское
suspicious|подозрительный 
assassin|убийца (наемный)
sentence|предложение; приговор; осуждать, приговаривать 
fifth|пятый 
lonely|одинокий
zip|застежка-молния; застегивать(ся) на молнию 
proof|доказательство; испытание, проба; непроницаемый
microphone|микрофон
attractive|привлекательный, притягательный 
political|политический 
aid|помощь; помогать 
stamp|штамп; марка; ставить штамп, печать
piano|фортепьяно, рояль
admire|восхищаться; любоваться 
fairly|честно, справедливо; довольно; весьма; ясно 
cute|прелестный, умный 
property|собственность, имущество; свойство, качество 
wail|вопль; вой; громкий плач; вопить, выть 
naturally|естественно; конечно, разумеется 
pencil|карандаш 
regret|сожаление; раскаяние; сожалеть; раскаиваться 
shed|сарай, навес
holly|уст. = wholly полностью, целиком, вполне 
citizen|гражданин, гражданка; горожанин, горожанка 
clever|умный, способный
downtown|амер. в деловой части города, в центре 
handkerchief|носовой платок
ramp|скат, уклон; пандус; рампа; место стоянки, причал 
fortune|удача; счастье
lung|анат. лёгкое;  ~s голос 
article|статья; артикль
eighteen|восемнадцать 
apply|прикладывать; обращаться (к, за); использовать, применять
bless|благословлять
tend|заботиться, ухаживать; иметь тенденцию, склонность 
tan|загар; загорать 
complain|жаловаться; выражать недовольство 
example|пример, образец, экземпляр
basket|корзина 
super|разг. превосходный; сверх-; над- 
vault|1) архит. свод; погреб; 2) прыжок; перепрыгивать 
girlfriend|подруга; (любимая) девушка 
ability|способность
limb|конечность (руки, ноги) 
occasionally|изредка; время от времени 
tag|ярлык; этикетка; бирка; навешивать ярлык и др. 
earn|зарабатывать; earnings заработок 
seize|хватать, схватить
therefore|поэтому, следовательно 
dealer|торговец, торговый агент
companion|спутник
confusion|смущение, замешательство; беспорядок,
warehouse|склад, хранилище; оптовый магазин 
bath|ванна 
collection|собирание, сбор; коллекция 
craft|ремесло; умение, ловкость; хитрость, обман 
actor|актер, артист 
chaos|хаос, полный беспорядок
rod|прут; стержень 
occupy|занимать (место, должность, и т.п.); оккупировать 
sack|мешок; (редко) класть в мешок; выгонять с работы 
suicide|самоубийство
funeral|похороны; похоронный 
lesson|урок 
ginger|разг. приподнятое настроение; рыжеволосый (человек) 
gin|джин 
prevent|предотвращать; предупреждать; препятствовать 
occasion|случай; событие; повод 
meanwhile|(= meantime)тем временем 
chili|острый перец 
fur|мех 
garbage|отбросы; мусор
tangle|путаница; спутывать(ся), запутывать(ся) 
peek|1) взгляд украдкой; взглянутьь; 2) амер. писк; пищать 
rape|изнасилование; изнасиловать 
ram|баран; воен. таран; таранить; вдалбливать 
social|общественный, социальный 
ordinary|обычный
modern|современный 
lion|лев  
agreement|согласие; соглашение, договор 
homicide|юр. убийство
thump|тяжелый удар (кулаком); наносить тяжелый удар 
division|деление; распределение; отдел, раздел; отделение 
laboratory|лаборатория
horrify|ужасать, страшить 
spike|острие, шип; пронзать; прибивать гвоздями и др. 
sixteen|шестнадцать 
previous|предыдущий 
rumour|бр. = rumor ам. (1:8) слух, молва; распространять слухи
resist|сопротивляться 
notebook|тетрадь, блокнот
benefit|выгода, польза 
slug|1) слизняк; лентяй; лениться; 2) пуля; жетон; стрелять; 3) удар; разочарование; сильно бить
debris|осколки, обломки; остатки; развалины 
solve|решать, разрешать (проблему, задачу); объяснить; выполнять 
journey|поездка; путешествие
retire|удаляться, уходить; оставлять должность 
chop|удар (рубящий); рубить
trooper|воен. десантник; танкист; кавалерист 
possess|владеть, обладать
permit|разрешение, лицензия, пропуск; разрешать, позволять 
sugar|сахар 
conscious|сознающий, понимающий; находящ. в сознании 
rig|1) приспособление; оснащать; 2) разг. проделка; дейст. нечестно; 3) диал. распутница; распутничать
football|футбол 
mob|толпа, сборище 
hunch|горб; горбить(ся), сутулить(ся) 
lone|одинокий; уединенный 
excellent|превосходный, отличный 
pose|поза; позировать; ставить (вопрос); создавать (проблему)
atmosphere|атмосфера
available|имеющийся; наличный, доступный; (при)годный
apologize|извиняться
snort|фыркать; пыхтеть 
international|международный 
sexual|половой, сексуальный
highly|очень, весьма, чрезвычайно; высоко 
drape|украшать тканями; драпировать 
pavement|тротуар; амер. мостовая 
lighter|зажигалка; запал 
cuff|манжета, обшлаг; сокр. наручники; надеть наручники
boyfriend|друг, приятель (девушки)
bind (bound; bound )|связывать; привязывать; повязывать; переплетать
plead|просить, умолять
sting (stung; stung )|жалить; мучить, терзать; жало; укус
loom|неясные очертания, мираж; неясно вырисовываться
responsible|ответственный (перед кем-л.; за что-л.) 
assignment|назначение;
express|1) выражать; 2) определенный; срочный 
defeat|поражение; крушение; побеждать; разрушать 
underground|метро; подземный; под землей
custom|обычай; привычка; ~s таможня
